Rank,NOC,Gold,Silver,Bronze,Total,Year,IOC_Code
1,United States,11,7,2,20,1896,USA
2,Greece,10,18,19,47,1896,GRE
3,Germany,6,5,2,13,1896,GER
4,France,5,4,2,11,1896,FRA
5,Great Britain,2,3,2,7,1896,GBR
6,Hungary,2,1,3,6,1896,HUN
7,Austria,2,1,2,5,1896,AUT
8,Australia,2,0,0,2,1896,AUS
9,Denmark,1,2,3,6,1896,DEN
10,Switzerland,1,2,0,3,1896,SUI
11,Mixed team,1,0,1,2,1896,MIX
1,France,27,39,37,103,1900,FRA
2,United States,19,14,15,48,1900,USA
3,Great Britain,15,7,9,31,1900,GBR
4,Mixed team,8,5,6,19,1900,MIX
5,Belgium,6,7,4,17,1900,BEL
6,Switzerland,6,2,1,9,1900,SUI
7,Germany,4,3,2,9,1900,GER
8,Italy,3,2,0,5,1900,ITA
9,Australia,2,0,3,5,1900,AUS
10,Denmark,1,3,2,6,1900,DEN
11,Hungary,1,2,2,5,1900,HUN
12,Cuba,1,1,0,2,1900,CUB
13,Canada,1,0,1,2,1900,CAN
14,Spain,1,0,0,1,1900,ESP
14,Luxembourg,1,0,0,1,1900,LUX
16,Austria,0,3,3,6,1900,AUT
17,Norway,0,2,3,5,1900,NOR
17,Netherlands,0,2,3,5,1900,NED
19,India,0,2,0,2,1900,IND
20,Bohemia,0,1,1,2,1900,CZE
21,Sweden,0,0,1,1,1900,SWE
1,United States,76,78,77,231,1904,USA
2,Germany,4,5,6,15,1904,GER
3,Canada,4,1,1,6,1904,CAN
4,Cuba,3,0,0,3,1904,CUB
5,Hungary,2,1,1,4,1904,HUN
5,Mixed team,2,1,1,4,1904,MIX
7,Norway,2,0,0,2,1904,NOR
8,Austria,1,1,1,3,1904,AUT
9,Great Britain,1,1,0,2,1904,GBR
10,Switzerland,1,0,2,3,1904,SUI
11,Greece,1,0,1,2,1904,GRE
12,Australia,0,3,1,4,1904,AUS
13,France,0,1,0,1,1904,FRA
1,Great Britain,56,51,39,146,1908,GBR
2,United States,23,12,12,47,1908,USA
3,Sweden,8,6,11,25,1908,SWE
4,France,5,5,9,19,1908,FRA
5,Germany,3,5,5,13,1908,GER
6,Hungary,3,4,2,9,1908,HUN
7,Canada,3,3,10,16,1908,CAN
8,Norway,2,3,3,8,1908,NOR
9,Italy,2,2,0,4,1908,ITA
10,Belgium,1,5,2,8,1908,BEL
11,Australasia,1,2,2,5,1908,ANZ
12,Russian Empire,1,2,0,3,1908,RUS
13,Finland,1,1,3,5,1908,FIN
14,South Africa,1,1,0,2,1908,RSA
15,Greece,0,3,1,4,1908,GRE
16,Denmark,0,2,3,5,1908,DEN
17,Bohemia,0,0,2,2,1908,CZE
17,Netherlands,0,0,2,2,1908,NED
19,Austria,0,0,1,1,1908,AUT
1,United States,26,19,19,64,1912,USA
2,Sweden,23,25,17,65,1912,SWE
3,Great Britain,10,15,16,41,1912,GBR
4,Finland,9,8,9,26,1912,FIN
5,France,7,4,3,14,1912,FRA
6,Germany,5,13,7,25,1912,GER
7,South Africa,4,2,0,6,1912,RSA
8,Norway,3,2,5,10,1912,NOR
9,Canada,3,2,3,8,1912,CAN
9,Hungary,3,2,3,8,1912,HUN
11,Italy,3,1,2,6,1912,ITA
12,Australasia,2,2,3,7,1912,ANZ
13,Belgium,2,1,3,6,1912,BEL
14,Denmark,1,6,5,12,1912,DEN
15,Greece,1,0,1,2,1912,GRE
16,Russian Empire,0,2,3,5,1912,RUS
17,Austria,0,2,2,4,1912,AUT
18,Netherlands,0,0,3,3,1912,NED
1,United States,41,27,27,95,1920,USA
2,Sweden,19,20,25,64,1920,SWE
3,Finland,15,10,9,34,1920,FIN
4,Great Britain,14,15,13,42,1920,GBR
5,Belgium,14,11,11,36,1920,BEL
6,Norway,13,9,9,31,1920,NOR
7,Italy,13,5,5,23,1920,ITA
8,France,9,19,13,41,1920,FRA
9,Netherlands,4,2,5,11,1920,NED
10,Denmark,3,9,1,13,1920,DEN
11,South Africa,3,4,3,10,1920,RSA
12,Canada,3,3,3,9,1920,CAN
13,Switzerland,2,2,7,11,1920,SUI
14,Estonia,1,2,0,3,1920,EST
15,Brazil,1,1,1,3,1920,BRA
16,Australia,0,2,1,3,1920,AUS
17,Japan,0,2,0,2,1920,JPN
17,Spain,0,2,0,2,1920,ESP
19,Greece,0,1,0,1,1920,GRE
19,Luxembourg,0,1,0,1,1920,LUX
21,Czechoslovakia,0,0,2,2,1920,CZE
22,New Zealand,0,0,1,1,1920,NZL
1,United States,45,27,27,99,1924,USA
2,Finland,14,13,10,37,1924,FIN
3,France,13,15,10,38,1924,FRA
4,Great Britain,9,13,12,34,1924,GBR
5,Italy,8,3,5,16,1924,ITA
6,Switzerland,7,8,10,25,1924,SUI
7,Norway,5,2,3,10,1924,NOR
8,Sweden,4,13,12,29,1924,SWE
9,Netherlands,4,1,5,10,1924,NED
10,Belgium,3,7,3,13,1924,BEL
11,Australia,3,1,2,6,1924,AUS
12,Denmark,2,5,2,9,1924,DEN
13,Hungary,2,3,4,9,1924,HUN
14,Yugoslavia,2,0,0,2,1924,SRB
15,Czechoslovakia,1,4,5,10,1924,CZE
16,Argentina,1,3,2,6,1924,ARG
17,Estonia,1,1,4,6,1924,EST
18,South Africa,1,1,1,3,1924,RSA
19,Uruguay,1,0,0,1,1924,URU
20,Austria,0,3,1,4,1924,AUT
20,Canada,0,3,1,4,1924,CAN
22,Poland,0,1,1,2,1924,POL
23,Haiti,0,0,1,1,1924,HAI
23,Japan,0,0,1,1,1924,JPN
23,New Zealand,0,0,1,1,1924,NZL
23,Portugal,0,0,1,1,1924,POR
23,Romania,0,0,1,1,1924,ROU
1,United States,22,18,16,56,1928,USA
2,Germany,10,7,14,31,1928,GER
3,Finland,8,8,9,25,1928,FIN
4,Sweden,7,6,12,25,1928,SWE
5,Italy,7,5,7,19,1928,ITA
6,Switzerland,7,4,4,15,1928,SUI
7,France,6,10,5,21,1928,FRA
8,Netherlands,6,9,4,19,1928,NED
9,Hungary,4,5,0,9,1928,HUN
10,Canada,4,4,7,15,1928,CAN
11,Great Britain,3,10,7,20,1928,GBR
12,Argentina,3,3,1,7,1928,ARG
13,Denmark,3,1,2,6,1928,DEN
14,Czechoslovakia,2,5,2,9,1928,CZE
15,Japan,2,2,1,5,1928,JPN
16,Estonia,2,1,2,5,1928,EST
17,Egypt,2,1,1,4,1928,EGY
18,Austria,2,0,1,3,1928,AUT
19,Australia,1,2,1,4,1928,AUS
19,Norway,1,2,1,4,1928,NOR
21,Poland,1,1,3,5,1928,POL
21,Yugoslavia,1,1,3,5,1928,SRB
23,South Africa,1,0,2,3,1928,RSA
24,India,1,0,0,1,1928,IND
24,Ireland,1,0,0,1,1928,GBR
24,New Zealand,1,0,0,1,1928,NZL
24,Spain,1,0,0,1,1928,ESP
24,Uruguay,1,0,0,1,1928,URU
29,Belgium,0,1,2,3,1928,BEL
30,Chile,0,1,0,1,1928,CHI
30,Haiti,0,1,0,1,1928,HAI
32,Philippines,0,0,1,1,1928,PHI
32,Portugal,0,0,1,1,1928,POR
1,United States ,44,36,30,110,1932,USA
2,Italy ,12,12,12,36,1932,ITA
3,France ,11,5,4,20,1932,FRA
4,Sweden ,10,5,9,24,1932,SWE
5,Japan ,7,7,4,18,1932,JPN
6,Hungary ,6,5,5,16,1932,HUN
7,Germany ,5,12,7,24,1932,GER
8,Finland ,5,8,12,25,1932,FIN
9,Great Britain ,5,7,5,17,1932,GBR
10,Poland ,3,2,4,9,1932,POL
11,Australia ,3,1,1,5,1932,AUS
12,Argentina ,3,1,0,4,1932,ARG
13,Canada ,2,5,9,16,1932,CAN
14,Netherlands ,2,5,1,8,1932,NED
15,South Africa ,2,0,3,5,1932,RSA
16,Ireland ,2,0,0,2,1932,GBR
17,Czechoslovakia ,1,3,2,6,1932,CZE
18,Austria ,1,1,3,5,1932,AUT
19,India ,1,0,0,1,1932,IND
20,Denmark ,0,5,3,8,1932,DEN
21,Mexico ,0,2,0,2,1932,MEX
22,Latvia ,0,1,0,1,1932,LAT
22,New Zealand ,0,1,0,1,1932,NZL
22,Switzerland ,0,1,0,1,1932,SUI
25,Philippines ,0,0,3,3,1932,PHI
26,Belgium ,0,0,1,1,1932,BEL
26,Spain ,0,0,1,1,1932,ESP
26,Uruguay ,0,0,1,1,1932,URU
1,Germany,38,31,32,101,1936,GER
2,United States,24,21,12,57,1936,USA
3,Hungary,10,1,5,16,1936,HUN
4,Italy,9,13,5,27,1936,ITA
5,Finland,8,6,6,20,1936,FIN
6,France,7,6,6,19,1936,FRA
7,Sweden,6,5,10,21,1936,SWE
8,Japan,6,4,10,20,1936,JPN
9,Netherlands,6,4,7,17,1936,NED
10,Austria,5,7,5,17,1936,AUT
11,Switzerland,4,9,5,18,1936,SUI
12,Great Britain,4,7,3,14,1936,GBR
13,Czechoslovakia,3,5,1,9,1936,CZE
14,Argentina,2,2,3,7,1936,ARG
14,Estonia,2,2,3,7,1936,EST
16,Egypt,2,1,2,5,1936,EGY
17,Canada,1,3,5,9,1936,CAN
18,Norway,1,3,2,6,1936,NOR
19,Turkey,1,0,1,2,1936,TUR
20,India,1,0,0,1,1936,IND
20,New Zealand,1,0,0,1,1936,NZL
22,Poland,0,4,5,9,1936,POL
23,Denmark,0,2,3,5,1936,DEN
24,Latvia,0,1,1,2,1936,LAT
25,Romania,0,1,0,1,1936,ROU
25,South Africa,0,1,0,1,1936,RSA
25,Yugoslavia,0,1,0,1,1936,SRB
28,Belgium,0,0,3,3,1936,BEL
28,Mexico,0,0,3,3,1936,MEX
30,Australia,0,0,1,1,1936,AUS
30,Philippines,0,0,1,1,1936,PHI
30,Portugal,0,0,1,1,1936,POR
1,United States,38,27,19,84,1948,USA
2,Sweden,16,11,17,44,1948,SWE
3,France,10,6,13,29,1948,FRA
4,Hungary,10,5,12,27,1948,HUN
5,Italy,8,11,8,27,1948,ITA
6,Finland,8,7,5,20,1948,FIN
7,Turkey,6,4,2,12,1948,TUR
8,Czechoslovakia,6,2,3,11,1948,CZE
9,Switzerland,5,10,5,20,1948,SUI
10,Denmark,5,7,8,20,1948,DEN
11,Netherlands,5,2,9,16,1948,NED
12,Great Britain,3,14,6,23,1948,GBR
13,Argentina,3,3,1,7,1948,ARG
14,Australia,2,6,5,13,1948,AUS
15,Belgium,2,2,3,7,1948,BEL
16,Egypt,2,2,1,5,1948,EGY
17,Mexico,2,1,2,5,1948,MEX
18,South Africa,2,1,1,4,1948,RSA
19,Norway,1,3,3,7,1948,NOR
20,Jamaica,1,2,0,3,1948,JAM
21,Austria,1,0,3,4,1948,AUT
22,India,1,0,0,1,1948,IND
22,Peru,1,0,0,1,1948,PER
24,Yugoslavia,0,2,0,2,1948,SRB
25,Canada,0,1,2,3,1948,CAN
26,Portugal,0,1,1,2,1948,POR
26,Uruguay,0,1,1,2,1948,URU
28,Ceylon,0,1,0,1,1948,ISL
28,Cuba,0,1,0,1,1948,CUB
28,Spain,0,1,0,1,1948,ESP
28,Trinidad and Tobago,0,1,0,1,1948,TTO
32,Panama,0,0,2,2,1948,PAN
32,South Korea,0,0,2,2,1948,KOR
34,Brazil,0,0,1,1,1948,BRA
34,Iran,0,0,1,1,1948,IRI
34,Poland,0,0,1,1,1948,POL
34,Puerto Rico,0,0,1,1,1948,PUR
1,United States,40,19,17,76,1952,USA
2,Soviet Union,22,30,19,71,1952,RUS
3,Hungary,16,10,16,42,1952,HUN
4,Sweden,12,13,10,35,1952,SWE
5,Italy,8,9,4,21,1952,ITA
6,Czechoslovakia,7,3,3,13,1952,CZE
7,France,6,6,6,18,1952,FRA
8,Finland,6,3,13,22,1952,FIN
9,Australia,6,2,3,11,1952,AUS
10,Norway,3,2,0,5,1952,NOR
11,Switzerland,2,6,6,14,1952,SUI
12,South Africa,2,4,4,10,1952,RSA
13,Jamaica,2,3,0,5,1952,JAM
14,Belgium,2,2,0,4,1952,BEL
15,Denmark,2,1,3,6,1952,DEN
16,Turkey,2,0,1,3,1952,TUR
17,Japan,1,6,2,9,1952,JPN
18,Great Britain,1,2,8,11,1952,GBR
19,Argentina,1,2,2,5,1952,ARG
20,Poland,1,2,1,4,1952,POL
21,Canada,1,2,0,3,1952,CAN
21,Yugoslavia,1,2,0,3,1952,SRB
23,Romania,1,1,2,4,1952,ROU
24,Brazil,1,0,2,3,1952,BRA
24,New Zealand,1,0,2,3,1952,NZL
26,India,1,0,1,2,1952,IND
27,Luxembourg,1,0,0,1,1952,LUX
28,Germany,0,7,17,24,1952,GER
29,Netherlands,0,5,0,5,1952,NED
30,Iran,0,3,4,7,1952,IRI
31,Chile,0,2,0,2,1952,CHI
32,Austria,0,1,1,2,1952,AUT
32,Lebanon,0,1,1,2,1952,LBN
34,Ireland,0,1,0,1,1952,GBR
34,Mexico,0,1,0,1,1952,MEX
34,Spain,0,1,0,1,1952,ESP
37,South Korea,0,0,2,2,1952,KOR
37,Trinidad and Tobago,0,0,2,2,1952,TTO
37,Uruguay,0,0,2,2,1952,URU
40,Bulgaria,0,0,1,1,1952,BUL
40,Egypt,0,0,1,1,1952,EGY
40,Portugal,0,0,1,1,1952,POR
40,Venezuela,0,0,1,1,1952,VEN
1,Soviet Union,37,29,32,98,1956,RUS
2,United States,32,25,17,74,1956,USA
3,Australia,13,8,14,35,1956,AUS
4,Hungary,9,10,7,26,1956,HUN
5,Italy,8,8,9,25,1956,ITA
6,Sweden,8,5,6,19,1956,SWE
7,United Team of Germany,6,13,7,26,1956,GER
8,Great Britain,6,7,11,24,1956,GBR
9,Romania,5,3,5,13,1956,ROU
10,Japan,4,10,5,19,1956,JPN
11,France,4,4,6,14,1956,FRA
12,Turkey,3,2,2,7,1956,TUR
13,Finland,3,1,11,15,1956,FIN
14,Iran,2,2,1,5,1956,IRI
15,Canada,2,1,3,6,1956,CAN
16,New Zealand,2,0,0,2,1956,NZL
17,Poland,1,4,4,9,1956,POL
18,Czechoslovakia,1,4,1,6,1956,CZE
19,Bulgaria,1,3,1,5,1956,BUL
20,Denmark,1,2,1,4,1956,DEN
21,Ireland,1,1,3,5,1956,GBR
22,Norway,1,0,2,3,1956,NOR
23,Mexico,1,0,1,2,1956,MEX
24,Brazil,1,0,0,1,1956,BRA
24,India,1,0,0,1,1956,IND
26,Yugoslavia,0,3,0,3,1956,SRB
27,Chile,0,2,2,4,1956,CHI
28,Belgium,0,2,0,2,1956,BEL
29,Argentina,0,1,1,2,1956,ARG
29,South Korea,0,1,1,2,1956,KOR
31,Iceland,0,1,0,1,1956,ISL
31,Pakistan,0,1,0,1,1956,PAK
33,South Africa,0,0,4,4,1956,RSA
34,Austria,0,0,2,2,1956,AUT
35,Bahamas,0,0,1,1,1956,BAH
35,Greece,0,0,1,1,1956,GRE
35,Switzerland,0,0,1,1,1956,SUI
35,Uruguay,0,0,1,1,1956,URU
1,Soviet Union ,43,29,31,103,1960,RUS
2,United States ,34,21,16,71,1960,USA
3,Italy ,13,10,13,36,1960,ITA
4,United Team of Germany ,12,19,11,42,1960,GER
5,Australia ,8,8,6,22,1960,AUS
6,Turkey ,7,2,0,9,1960,TUR
7,Hungary ,6,8,7,21,1960,HUN
8,Japan ,4,7,7,18,1960,JPN
9,Poland ,4,6,11,21,1960,POL
10,Czechoslovakia ,3,2,3,8,1960,CZE
11,Romania ,3,1,6,10,1960,ROU
12,Great Britain ,2,6,12,20,1960,GBR
13,Denmark ,2,3,1,6,1960,DEN
14,New Zealand ,2,0,1,3,1960,NZL
15,Bulgaria ,1,3,3,7,1960,BUL
16,Sweden ,1,2,3,6,1960,SWE
17,Finland ,1,1,3,5,1960,FIN
18,Austria ,1,1,0,2,1960,AUT
18,Yugoslavia ,1,1,0,2,1960,SRB
20,Pakistan ,1,0,1,2,1960,PAK
21,Ethiopia ,1,0,0,1,1960,ETH
21,Greece ,1,0,0,1,1960,GRE
21,Norway ,1,0,0,1,1960,NOR
24,Switzerland ,0,3,3,6,1960,SUI
25,France ,0,2,3,5,1960,FRA
26,Belgium ,0,2,2,4,1960,BEL
27,Iran ,0,1,3,4,1960,IRI
28,Netherlands ,0,1,2,3,1960,NED
28,South Africa ,0,1,2,3,1960,RSA
30,Argentina ,0,1,1,2,1960,ARG
30,Egypt ,0,1,1,2,1960,EGY
32,Canada ,0,1,0,1,1960,CAN
32,Formosa ,0,1,0,1,1960,TPE
32,Ghana ,0,1,0,1,1960,GHA
32,India ,0,1,0,1,1960,IND
32,Morocco ,0,1,0,1,1960,MAR
32,Portugal ,0,1,0,1,1960,POR
32,Singapore ,0,1,0,1,1960,SGP
39,Brazil ,0,0,2,2,1960,BRA
39,British West Indies ,0,0,2,2,1960,JAM
41,Iraq ,0,0,1,1,1960,IRQ
41,Mexico ,0,0,1,1,1960,MEX
41,Spain ,0,0,1,1,1960,ESP
41,Venezuela ,0,0,1,1,1960,VEN
1,United States,36,26,28,90,1964,USA
2,Soviet Union,30,31,35,96,1964,RUS
3,Japan,16,5,8,29,1964,JPN
4,United Team of Germany,10,22,18,50,1964,GER
5,Italy,10,10,7,27,1964,ITA
6,Hungary,10,7,5,22,1964,HUN
7,Poland,7,6,10,23,1964,POL
8,Australia,6,2,10,18,1964,AUS
9,Czechoslovakia,5,6,3,14,1964,CZE
10,Great Britain,4,12,2,18,1964,GBR
11,Bulgaria,3,5,2,10,1964,BUL
12,Finland,3,0,2,5,1964,FIN
12,New Zealand,3,0,2,5,1964,NZL
14,Romania,2,4,6,12,1964,ROU
15,Netherlands,2,4,4,10,1964,NED
16,Turkey,2,3,1,6,1964,TUR
17,Sweden,2,2,4,8,1964,SWE
18,Denmark,2,1,3,6,1964,DEN
19,Yugoslavia,2,1,2,5,1964,SRB
20,Belgium,2,0,1,3,1964,BEL
21,France,1,8,6,15,1964,FRA
22,Canada,1,2,1,4,1964,CAN
22,Switzerland,1,2,1,4,1964,SUI
24,Bahamas,1,0,0,1,1964,BAH
24,Ethiopia,1,0,0,1,1964,ETH
24,India,1,0,0,1,1964,IND
27,South Korea,0,2,1,3,1964,KOR
28,Trinidad and Tobago,0,1,2,3,1964,TTO
29,Tunisia,0,1,1,2,1964,TUN
30,Argentina,0,1,0,1,1964,ARG
30,Cuba,0,1,0,1,1964,CUB
30,Pakistan,0,1,0,1,1964,PAK
30,Philippines,0,1,0,1,1964,PHI
34,Iran,0,0,2,2,1964,IRI
35,Brazil,0,0,1,1,1964,BRA
35,Ghana,0,0,1,1,1964,GHA
35,Ireland,0,0,1,1,1964,GBR
35,Kenya,0,0,1,1,1964,KEN
35,Mexico,0,0,1,1,1964,MEX
35,Nigeria,0,0,1,1,1964,NIG
35,Uruguay,0,0,1,1,1964,URU
1,United States,45,28,34,107,1968,USA
2,Soviet Union,29,32,30,91,1968,RUS
3,Japan,11,7,7,25,1968,JPN
4,Hungary,10,10,12,32,1968,HUN
5,East Germany,9,9,7,25,1968,GER
6,France,7,3,5,15,1968,FRA
7,Czechoslovakia,7,2,4,13,1968,CZE
8,West Germany,5,11,10,26,1968,GER
9,Australia,5,7,5,17,1968,AUS
10,Great Britain,5,5,3,13,1968,GBR
11,Poland,5,2,11,18,1968,POL
12,Romania,4,6,5,15,1968,ROU
13,Italy,3,4,9,16,1968,ITA
14,Kenya,3,4,2,9,1968,KEN
15,Mexico,3,3,3,9,1968,MEX
16,Yugoslavia,3,3,2,8,1968,SRB
17,Netherlands,3,3,1,7,1968,NED
18,Bulgaria,2,4,3,9,1968,BUL
19,Iran,2,1,2,5,1968,IRI
20,Sweden,2,1,1,4,1968,SWE
21,Turkey,2,0,0,2,1968,TUR
22,Denmark,1,4,3,8,1968,DEN
23,Canada,1,3,1,5,1968,CAN
24,Finland,1,2,1,4,1968,FIN
25,Ethiopia,1,1,0,2,1968,ETH
25,Norway,1,1,0,2,1968,NOR
27,New Zealand,1,0,2,3,1968,NZL
28,Tunisia,1,0,1,2,1968,TUN
29,Pakistan,1,0,0,1,1968,PAK
29,Venezuela,1,0,0,1,1968,VEN
31,Cuba,0,4,0,4,1968,CUB
32,Austria,0,2,2,4,1968,AUT
33,Switzerland,0,1,4,5,1968,SUI
34,Mongolia,0,1,3,4,1968,MGL
35,Brazil,0,1,2,3,1968,BRA
36,Belgium,0,1,1,2,1968,BEL
36,South Korea,0,1,1,2,1968,KOR
36,Uganda,0,1,1,2,1968,UGA
39,Cameroon,0,1,0,1,1968,CMR
39,Jamaica,0,1,0,1,1968,JAM
41,Argentina,0,0,2,2,1968,ARG
42,Greece,0,0,1,1,1968,GRE
42,India,0,0,1,1,1968,IND
42,Taiwan,0,0,1,1,1968,TPE
1,Soviet Union,50,27,22,99,1972,RUS
2,United States,33,31,30,94,1972,USA
3,East Germany,20,23,23,66,1972,GER
4,West Germany,13,11,16,40,1972,GER
5,Japan,13,8,8,29,1972,JPN
6,Australia,8,7,2,17,1972,AUS
7,Poland,7,5,9,21,1972,POL
8,Hungary,6,13,16,35,1972,HUN
9,Bulgaria,6,10,5,21,1972,BUL
10,Italy,5,3,10,18,1972,ITA
11,Sweden,4,6,6,16,1972,SWE
12,Great Britain,4,5,9,18,1972,GBR
13,Romania,3,6,7,16,1972,ROU
14,Cuba,3,1,4,8,1972,CUB
14,Finland,3,1,4,8,1972,FIN
16,Netherlands,3,1,1,5,1972,NED
17,France,2,4,7,13,1972,FRA
18,Czechoslovakia,2,4,2,8,1972,CZE
19,Kenya,2,3,4,9,1972,KEN
20,Yugoslavia,2,1,2,5,1972,SRB
21,Norway,2,1,1,4,1972,NOR
22,North Korea,1,1,3,5,1972,PRK
23,New Zealand,1,1,1,3,1972,NZL
24,Uganda,1,1,0,2,1972,UGA
25,Denmark,1,0,0,1,1972,DEN
26,Switzerland,0,3,0,3,1972,SUI
27,Canada,0,2,3,5,1972,CAN
28,Iran,0,2,1,3,1972,IRI
29,Belgium,0,2,0,2,1972,BEL
29,Greece,0,2,0,2,1972,GRE
31,Austria,0,1,2,3,1972,AUT
31,Colombia,0,1,2,3,1972,COL
33,Argentina,0,1,0,1,1972,ARG
33,Lebanon,0,1,0,1,1972,LBN
33,Mexico,0,1,0,1,1972,MEX
33,Mongolia,0,1,0,1,1972,MGL
33,Pakistan,0,1,0,1,1972,PAK
33,South Korea,0,1,0,1,1972,KOR
33,Tunisia,0,1,0,1,1972,TUN
33,Turkey,0,1,0,1,1972,TUR
41,Brazil,0,0,2,2,1972,BRA
41,Ethiopia,0,0,2,2,1972,ETH
43,Ghana,0,0,1,1,1972,GHA
43,India,0,0,1,1,1972,IND
43,Jamaica,0,0,1,1,1972,JAM
43,Niger,0,0,1,1,1972,NIG
43,Nigeria,0,0,1,1,1972,NIG
43,Spain,0,0,1,1,1972,ESP
1,Soviet Union,49,41,35,125,1976,RUS
2,East Germany,40,25,25,90,1976,GER
3,United States,34,35,25,94,1976,USA
4,West Germany,10,12,17,39,1976,GER
5,Japan,9,6,10,25,1976,JPN
6,Poland,7,6,13,26,1976,POL
7,Bulgaria,6,9,7,22,1976,BUL
8,Cuba,6,4,3,13,1976,CUB
9,Romania,4,9,14,27,1976,ROU
10,Hungary,4,5,13,22,1976,HUN
11,Finland,4,2,0,6,1976,FIN
12,Sweden,4,1,0,5,1976,SWE
13,Great Britain,3,5,5,13,1976,GBR
14,Italy,2,7,4,13,1976,ITA
15,France,2,3,4,9,1976,FRA
16,Yugoslavia,2,3,3,8,1976,SRB
17,Czechoslovakia,2,2,4,8,1976,CZE
18,New Zealand,2,1,1,4,1976,NZL
19,South Korea,1,1,4,6,1976,KOR
20,Switzerland,1,1,2,4,1976,SUI
21,Jamaica,1,1,0,2,1976,JAM
21,North Korea,1,1,0,2,1976,PRK
21,Norway,1,1,0,2,1976,NOR
24,Denmark,1,0,2,3,1976,DEN
25,Mexico,1,0,1,2,1976,MEX
26,Trinidad and Tobago,1,0,0,1,1976,TTO
27,Canada,0,5,6,11,1976,CAN
28,Belgium,0,3,3,6,1976,BEL
29,Netherlands,0,2,3,5,1976,NED
30,Portugal,0,2,0,2,1976,POR
30,Spain,0,2,0,2,1976,ESP
32,Australia,0,1,4,5,1976,AUS
33,Iran,0,1,1,2,1976,IRI
34,Mongolia,0,1,0,1,1976,MGL
34,Venezuela,0,1,0,1,1976,VEN
36,Brazil,0,0,2,2,1976,BRA
37,Austria,0,0,1,1,1976,AUT
37,Bermuda,0,0,1,1,1976,BER
37,Pakistan,0,0,1,1,1976,PAK
37,Puerto Rico,0,0,1,1,1976,PUR
37,Thailand,0,0,1,1,1976,THA
1,Soviet Union,80,69,46,195,1980,RUS
2,East Germany,47,37,42,126,1980,GER
3,Bulgaria,8,16,17,41,1980,BUL
4,Cuba,8,7,5,20,1980,CUB
5,Italy,8,3,4,15,1980,ITA
6,Hungary,7,10,15,32,1980,HUN
7,Romania,6,6,13,25,1980,ROU
8,France,6,5,3,14,1980,FRA
9,Great Britain,5,7,9,21,1980,GBR
10,Poland,3,14,15,32,1980,POL
11,Sweden,3,3,6,12,1980,SWE
12,Finland,3,1,4,8,1980,FIN
13,Czechoslovakia,2,3,9,14,1980,CZE
14,Yugoslavia,2,3,4,9,1980,SRB
15,Australia,2,2,5,9,1980,AUS
16,Denmark,2,1,2,5,1980,DEN
17,Brazil,2,0,2,4,1980,BRA
17,Ethiopia,2,0,2,4,1980,ETH
19,Switzerland,2,0,0,2,1980,SUI
20,Spain,1,3,2,6,1980,ESP
21,Austria,1,2,1,4,1980,AUT
22,Greece,1,0,2,3,1980,GRE
23,Belgium,1,0,0,1,1980,BEL
23,India,1,0,0,1,1980,IND
23,Zimbabwe,1,0,0,1,1980,ZIM
26,North Korea,0,3,2,5,1980,PRK
27,Mongolia,0,2,2,4,1980,MGL
28,Tanzania,0,2,0,2,1980,TAN
29,Mexico,0,1,3,4,1980,MEX
30,Netherlands,0,1,2,3,1980,NED
31,Ireland,0,1,1,2,1980,GBR
32,Uganda,0,1,0,1,1980,UGA
32,Venezuela,0,1,0,1,1980,VEN
34,Jamaica,0,0,3,3,1980,JAM
35,Guyana,0,0,1,1,1980,GUY
35,Lebanon,0,0,1,1,1980,LBN
1,United States,83,61,30,174,1984,USA
2,Romania,20,16,17,53,1984,ROU
3,West Germany,17,19,23,59,1984,GER
4,China,15,8,9,32,1984,CHN
5,Italy,14,6,12,32,1984,ITA
6,Canada,10,18,16,44,1984,CAN
7,Japan,10,8,14,32,1984,JPN
8,New Zealand,8,1,2,11,1984,NZL
9,Yugoslavia,7,4,7,18,1984,SRB
10,South Korea,6,6,7,19,1984,KOR
11,Great Britain,5,11,21,37,1984,GBR
12,France,5,7,16,28,1984,FRA
13,Netherlands,5,2,6,13,1984,NED
14,Australia,4,8,12,24,1984,AUS
15,Finland,4,2,6,12,1984,FIN
16,Sweden,2,11,6,19,1984,SWE
17,Mexico,2,3,1,6,1984,MEX
18,Morocco,2,0,0,2,1984,MAR
19,Brazil,1,5,2,8,1984,BRA
20,Spain,1,2,2,5,1984,ESP
21,Belgium,1,1,2,4,1984,BEL
22,Austria,1,1,1,3,1984,AUT
23,Kenya,1,0,2,3,1984,KEN
23,Portugal,1,0,2,3,1984,POR
25,Pakistan,1,0,0,1,1984,PAK
26,Switzerland,0,4,4,8,1984,SUI
27,Denmark,0,3,3,6,1984,DEN
28,Jamaica,0,1,2,3,1984,JAM
28,Norway,0,1,2,3,1984,NOR
30,Greece,0,1,1,2,1984,GRE
30,Nigeria,0,1,1,2,1984,NIG
30,Puerto Rico,0,1,1,2,1984,PUR
33,Colombia,0,1,0,1,1984,COL
33,Egypt,0,1,0,1,1984,EGY
33,Ireland,0,1,0,1,1984,GBR
33,Ivory Coast,0,1,0,1,1984,CIV
33,Peru,0,1,0,1,1984,PER
33,Syria,0,1,0,1,1984,SYR
33,Thailand,0,1,0,1,1984,THA
40,Turkey,0,0,3,3,1984,TUR
40,Venezuela,0,0,3,3,1984,VEN
42,Algeria,0,0,2,2,1984,ALG
43,Cameroon,0,0,1,1,1984,CMR
43,Chinese Taipei,0,0,1,1,1984,TPE
43,Dominican Republic,0,0,1,1,1984,DOM
43,Iceland,0,0,1,1,1984,ISL
43,Zambia,0,0,1,1,1984,ZAM
1,Soviet Union,55,31,46,132,1988,RUS
2,East Germany,37,35,30,102,1988,GER
3,United States,36,31,27,94,1988,USA
4,South Korea,12,10,11,33,1988,KOR
5,West Germany,11,14,15,40,1988,GER
6,Hungary,11,6,6,23,1988,HUN
7,Bulgaria,10,12,13,35,1988,BUL
8,Romania,7,11,6,24,1988,ROU
9,France,6,4,6,16,1988,FRA
10,Italy,6,4,4,14,1988,ITA
11,China,5,11,12,28,1988,CHN
12,Great Britain,5,10,9,24,1988,GBR
13,Kenya,5,2,2,9,1988,KEN
14,Japan,4,3,7,14,1988,JPN
15,Australia,3,6,5,14,1988,AUS
16,Yugoslavia,3,4,5,12,1988,SRB
17,Czechoslovakia,3,3,2,8,1988,CZE
18,New Zealand,3,2,8,13,1988,NZL
19,Canada,3,2,5,10,1988,CAN
20,Poland,2,5,9,16,1988,POL
21,Norway,2,3,0,5,1988,NOR
22,Netherlands,2,2,5,9,1988,NED
23,Denmark,2,1,1,4,1988,DEN
24,Brazil,1,2,3,6,1988,BRA
25,Finland,1,1,2,4,1988,FIN
25,Spain,1,1,2,4,1988,ESP
27,Turkey,1,1,0,2,1988,TUR
28,Morocco,1,0,2,3,1988,MAR
29,Austria,1,0,0,1,1988,AUT
29,Portugal,1,0,0,1,1988,POR
29,Suriname,1,0,0,1,1988,SUR
32,Sweden,0,4,7,11,1988,SWE
33,Switzerland,0,2,2,4,1988,SUI
34,Jamaica,0,2,0,2,1988,JAM
35,Argentina,0,1,1,2,1988,ARG
36,Chile,0,1,0,1,1988,CHI
36,Costa Rica,0,1,0,1,1988,CRC
36,Indonesia,0,1,0,1,1988,INA
36,Iran,0,1,0,1,1988,IRI
36,Netherlands Antilles,0,1,0,1,1988,AHO
36,Peru,0,1,0,1,1988,PER
36,Senegal,0,1,0,1,1988,SEN
36,Virgin Islands,0,1,0,1,1988,ISV
44,Belgium,0,0,2,2,1988,BEL
44,Mexico,0,0,2,2,1988,MEX
46,Colombia,0,0,1,1,1988,COL
46,Djibouti,0,0,1,1,1988,DJI
46,Greece,0,0,1,1,1988,GRE
46,Mongolia,0,0,1,1,1988,MGL
46,Pakistan,0,0,1,1,1988,PAK
46,Philippines,0,0,1,1,1988,PHI
46,Thailand,0,0,1,1,1988,THA
1,Unified Team,45,38,29,112,1992,EUN
2,United States,37,34,37,108,1992,USA
3,Germany,33,21,28,82,1992,GER
4,China,16,22,16,54,1992,CHN
5,Cuba,14,6,11,31,1992,CUB
6,Spain,13,7,2,22,1992,ESP
7,South Korea,12,5,12,29,1992,KOR
8,Hungary,11,12,7,30,1992,HUN
9,France,8,5,16,29,1992,FRA
10,Australia,7,9,11,27,1992,AUS
11,Canada,7,4,7,18,1992,CAN
12,Italy,6,5,8,19,1992,ITA
13,Great Britain,5,3,12,20,1992,GBR
14,Romania,4,6,8,18,1992,ROU
15,Czechoslovakia,4,2,1,7,1992,CZE
16,North Korea,4,0,5,9,1992,PRK
17,Japan,3,8,11,22,1992,JPN
18,Bulgaria,3,7,6,16,1992,BUL
19,Poland,3,6,10,19,1992,POL
20,Netherlands,2,6,7,15,1992,NED
21,Kenya,2,4,2,8,1992,KEN
22,Norway,2,4,1,7,1992,NOR
23,Turkey,2,2,2,6,1992,TUR
24,Indonesia,2,2,1,5,1992,INA
25,Brazil,2,1,0,3,1992,BRA
26,Greece,2,0,0,2,1992,GRE
27,Sweden,1,7,4,12,1992,SWE
28,New Zealand,1,4,5,10,1992,NZL
29,Finland,1,2,2,5,1992,FIN
30,Denmark,1,1,4,6,1992,DEN
31,Morocco,1,1,1,3,1992,MAR
32,Ireland,1,1,0,2,1992,GBR
33,Ethiopia,1,0,2,3,1992,ETH
34,Algeria,1,0,1,2,1992,ALG
34,Estonia,1,0,1,2,1992,EST
34,Lithuania,1,0,1,2,1992,LTU
37,Switzerland,1,0,0,1,1992,SUI
38,Jamaica,0,3,1,4,1992,JAM
38,Nigeria,0,3,1,4,1992,NIG
40,Latvia,0,2,1,3,1992,LAT
41,Austria,0,2,0,2,1992,AUT
41,Namibia,0,2,0,2,1992,NAM
41,South Africa,0,2,0,2,1992,RSA
44,Belgium,0,1,2,3,1992,BEL
44,Croatia,0,1,2,3,1992,CRO
44,Independent Olympic Participants,0,1,2,3,1992,IOP
44,Iran,0,1,2,3,1992,IRI
48,Israel,0,1,1,2,1992,ISR
49,Chinese Taipei,0,1,0,1,1992,TPE
49,Mexico,0,1,0,1,1992,MEX
49,Peru,0,1,0,1,1992,PER
52,Mongolia,0,0,2,2,1992,MGL
52,Slovenia,0,0,2,2,1992,SLO
54,Argentina,0,0,1,1,1992,ARG
54,Bahamas,0,0,1,1,1992,BAH
54,Colombia,0,0,1,1,1992,COL
54,Ghana,0,0,1,1,1992,GHA
54,Malaysia,0,0,1,1,1992,MAS
54,Pakistan,0,0,1,1,1992,PAK
54,Philippines,0,0,1,1,1992,PHI
54,Puerto Rico,0,0,1,1,1992,PUR
54,Qatar,0,0,1,1,1992,QAT
54,Suriname,0,0,1,1,1992,SUR
54,Thailand,0,0,1,1,1992,THA
1,United States,44,32,25,101,1996,USA
2,Russia,26,21,16,63,1996,ROC
3,Germany,20,18,27,65,1996,GER
4,China,16,22,12,50,1996,CHN
5,France,15,7,15,37,1996,FRA
6,Italy,13,10,12,35,1996,ITA
7,Australia,9,9,23,41,1996,AUS
8,Cuba,9,8,8,25,1996,CUB
9,Ukraine,9,2,12,23,1996,UKR
10,South Korea,7,15,5,27,1996,KOR
11,Poland,7,5,5,17,1996,POL
12,Hungary,7,4,10,21,1996,HUN
13,Spain,5,6,6,17,1996,ESP
14,Romania,4,7,9,20,1996,ROU
15,Netherlands,4,5,10,19,1996,NED
16,Greece,4,4,0,8,1996,GRE
17,Czech Republic,4,3,4,11,1996,CZE
18,Switzerland,4,3,0,7,1996,SUI
19,Denmark,4,1,1,6,1996,DEN
19,Turkey,4,1,1,6,1996,TUR
21,Canada,3,11,8,22,1996,CAN
22,Bulgaria,3,7,5,15,1996,BUL
23,Japan,3,6,5,14,1996,JPN
24,Kazakhstan,3,4,4,11,1996,KAZ
25,Brazil,3,3,9,15,1996,BRA
26,New Zealand,3,2,1,6,1996,NZL
27,South Africa,3,1,1,5,1996,RSA
28,Ireland,3,0,1,4,1996,GBR
29,Sweden,2,4,2,8,1996,SWE
30,Norway,2,2,3,7,1996,NOR
31,Belgium,2,2,2,6,1996,BEL
32,Nigeria,2,1,3,6,1996,NIG
33,North Korea,2,1,2,5,1996,PRK
34,Algeria,2,0,1,3,1996,ALG
34,Ethiopia,2,0,1,3,1996,ETH
36,Great Britain,1,8,6,15,1996,GBR
37,Belarus,1,6,8,15,1996,BLR
38,Kenya,1,4,3,8,1996,KEN
39,Jamaica,1,3,2,6,1996,JAM
40,Finland,1,2,1,4,1996,FIN
41,FR Yugoslavia,1,1,2,4,1996,SRB
41,Indonesia,1,1,2,4,1996,INA
43,Iran,1,1,1,3,1996,IRI
43,Slovakia,1,1,1,3,1996,SVK
45,Armenia,1,1,0,2,1996,ARM
45,Croatia,1,1,0,2,1996,CRO
47,Portugal,1,0,1,2,1996,POR
47,Thailand,1,0,1,2,1996,THA
49,Burundi,1,0,0,1,1996,BDI
49,Costa Rica,1,0,0,1,1996,CRC
49,Ecuador,1,0,0,1,1996,ECU
49,Hong Kong,1,0,0,1,1996,HKG
49,Syria,1,0,0,1,1996,SYR
54,Argentina,0,2,1,3,1996,ARG
55,Namibia,0,2,0,2,1996,NAM
55,Slovenia,0,2,0,2,1996,SLO
57,Austria,0,1,2,3,1996,AUT
58,Malaysia,0,1,1,2,1996,MAS
58,Moldova,0,1,1,2,1996,MDA
58,Uzbekistan,0,1,1,2,1996,UZB
61,Azerbaijan,0,1,0,1,1996,AZE
61,Bahamas,0,1,0,1,1996,BAH
61,Chinese Taipei,0,1,0,1,1996,TPE
61,Latvia,0,1,0,1,1996,LAT
61,Philippines,0,1,0,1,1996,PHI
61,Tonga,0,1,0,1,1996,TGA
61,Zambia,0,1,0,1,1996,ZAM
68,Georgia,0,0,2,2,1996,GEO
68,Morocco,0,0,2,2,1996,MAR
68,Trinidad and Tobago,0,0,2,2,1996,TTO
71,India,0,0,1,1,1996,IND
71,Israel,0,0,1,1,1996,ISR
71,Lithuania,0,0,1,1,1996,LTU
71,Mexico,0,0,1,1,1996,MEX
71,Mongolia,0,0,1,1,1996,MGL
71,Mozambique,0,0,1,1,1996,MOZ
71,Puerto Rico,0,0,1,1,1996,PUR
71,Tunisia,0,0,1,1,1996,TUN
71,Uganda,0,0,1,1,1996,UGA
1,United States,37,24,32,93,2000,USA
2,Russia,32,28,29,89,2000,ROC
3,China,28,16,14,58,2000,CHN
4,Australia,16,25,17,58,2000,AUS
5,Germany,13,17,26,56,2000,GER
6,France,13,14,11,38,2000,FRA
7,Italy,13,8,13,34,2000,ITA
8,Netherlands,12,9,4,25,2000,NED
9,Cuba,11,11,7,29,2000,CUB
10,Great Britain,11,10,7,28,2000,GBR
11,Romania,11,6,9,26,2000,ROU
12,South Korea,8,10,10,28,2000,KOR
13,Hungary,8,6,3,17,2000,HUN
14,Poland,6,5,3,14,2000,POL
15,Japan,5,8,5,18,2000,JPN
16,Bulgaria,5,6,2,13,2000,BUL
17,Greece,4,6,3,13,2000,GRE
18,Sweden,4,5,3,12,2000,SWE
19,Norway,4,3,3,10,2000,NOR
20,Ethiopia,4,1,3,8,2000,ETH
21,Ukraine,3,10,10,23,2000,UKR
22,Kazakhstan,3,4,0,7,2000,KAZ
23,Belarus,3,3,11,17,2000,BLR
24,Canada,3,3,8,14,2000,CAN
25,Spain,3,3,5,11,2000,ESP
26,Turkey,3,0,2,5,2000,TUR
27,Iran,3,0,1,4,2000,IRI
28,Czech Republic,2,3,3,8,2000,CZE
29,Kenya,2,3,2,7,2000,KEN
30,Denmark,2,3,1,6,2000,DEN
31,Finland,2,1,1,4,2000,FIN
32,Austria,2,1,0,3,2000,AUT
33,Lithuania,2,0,3,5,2000,LTU
34,Azerbaijan,2,0,1,3,2000,AZE
34,Bahamas,2,0,1,3,2000,BAH
36,Slovenia,2,0,0,2,2000,SLO
37,Switzerland,1,6,2,9,2000,SUI
38,Indonesia,1,3,2,6,2000,INA
39,Slovakia,1,3,1,5,2000,SVK
40,Mexico,1,2,3,6,2000,MEX
41,Nigeria,1,2,0,3,2000,NIG
42,Algeria,1,1,3,5,2000,ALG
43,Uzbekistan,1,1,2,4,2000,UZB
44,FR Yugoslavia,1,1,1,3,2000,SRB
44,Latvia,1,1,1,3,2000,LAT
46,New Zealand,1,0,3,4,2000,NZL
47,Estonia,1,0,2,3,2000,EST
47,Thailand,1,0,2,3,2000,THA
49,Croatia,1,0,1,2,2000,CRO
50,Cameroon,1,0,0,1,2000,CMR
50,Colombia,1,0,0,1,2000,COL
50,Mozambique,1,0,0,1,2000,MOZ
53,Brazil,0,6,6,12,2000,BRA
54,Jamaica,0,6,3,9,2000,JAM
55,Belgium,0,2,3,5,2000,BEL
55,South Africa,0,2,3,5,2000,RSA
57,Argentina,0,2,2,4,2000,ARG
58,Chinese Taipei,0,1,4,5,2000,TPE
58,Morocco,0,1,4,5,2000,MAR
60,North Korea,0,1,3,4,2000,PRK
61,Moldova,0,1,1,2,2000,MDA
61,Saudi Arabia,0,1,1,2,2000,KSA
61,Trinidad and Tobago,0,1,1,2,2000,TTO
64,Ireland,0,1,0,1,2000,GBR
64,Sri Lanka,0,1,0,1,2000,LKA
64,Uruguay,0,1,0,1,2000,URU
64,Vietnam,0,1,0,1,2000,VIE
68,Georgia,0,0,6,6,2000,GEO
69,Costa Rica,0,0,2,2,2000,CRC
69,Portugal,0,0,2,2,2000,POR
71,Armenia,0,0,1,1,2000,ARM
71,Barbados,0,0,1,1,2000,BAR
71,Chile,0,0,1,1,2000,CHI
71,Iceland,0,0,1,1,2000,ISL
71,India,0,0,1,1,2000,IND
71,Israel,0,0,1,1,2000,ISR
71,Kuwait,0,0,1,1,2000,KUW
71,Kyrgyzstan,0,0,1,1,2000,KGZ
71,Macedonia,0,0,1,1,2000,MKD
71,Qatar,0,0,1,1,2000,QAT
1,United States,36,39,26,101,2004,USA
2,China,32,17,14,63,2004,CHN
3,Russia,28,26,36,90,2004,ROC
4,Australia,17,16,17,50,2004,AUS
5,Japan,16,9,12,37,2004,JPN
6,Germany,13,16,20,49,2004,GER
7,France,11,9,13,33,2004,FRA
8,Italy,10,11,11,32,2004,ITA
9,South Korea,9,12,9,30,2004,KOR
10,Great Britain,9,9,12,30,2004,GBR
11,Cuba,9,7,11,27,2004,CUB
12,Hungary,8,6,3,17,2004,HUN
13,Ukraine,8,5,9,22,2004,UKR
14,Romania,8,5,6,19,2004,ROU
15,Greece,6,6,4,16,2004,GRE
16,Brazil,5,2,3,10,2004,BRA
17,Norway,5,0,1,6,2004,NOR
18,Netherlands,4,9,9,22,2004,NED
19,Sweden,4,2,1,7,2004,SWE
20,Spain,3,11,6,20,2004,ESP
21,Canada,3,6,3,12,2004,CAN
22,Turkey,3,3,4,10,2004,TUR
23,Poland,3,2,5,10,2004,POL
24,New Zealand,3,2,0,5,2004,NZL
25,Thailand,3,1,4,8,2004,THA
26,Belarus,2,5,6,13,2004,BLR
27,Austria,2,4,1,7,2004,AUT
28,Ethiopia,2,3,2,7,2004,ETH
29,Iran,2,2,2,6,2004,IRI
29,Slovakia,2,2,2,6,2004,SVK
31,Chinese Taipei,2,2,1,5,2004,TPE
32,Georgia,2,2,0,4,2004,GEO
33,Bulgaria,2,1,9,12,2004,BUL
34,Denmark,2,1,5,8,2004,DEN
35,Jamaica,2,1,2,5,2004,JAM
35,Uzbekistan,2,1,2,5,2004,UZB
37,Morocco,2,1,0,3,2004,MAR
38,Argentina,2,0,4,6,2004,ARG
39,Chile,2,0,1,3,2004,CHI
40,Kazakhstan,1,4,3,8,2004,KAZ
41,Kenya,1,4,2,7,2004,KEN
42,Czech Republic,1,3,5,9,2004,CZE
43,South Africa,1,3,2,6,2004,RSA
44,Croatia,1,2,2,5,2004,CRO
45,Lithuania,1,2,0,3,2004,LTU
46,Egypt,1,1,3,5,2004,EGY
46,Switzerland,1,1,3,5,2004,SUI
48,Indonesia,1,1,2,4,2004,INA
49,Zimbabwe,1,1,1,3,2004,ZIM
50,Azerbaijan,1,0,4,5,2004,AZE
51,Belgium,1,0,2,3,2004,BEL
52,Bahamas,1,0,1,2,2004,BAH
52,Israel,1,0,1,2,2004,ISR
54,Cameroon,1,0,0,1,2004,CMR
54,Dominican Republic,1,0,0,1,2004,DOM
54,United Arab Emirates,1,0,0,1,2004,UAE
57,North Korea,0,4,1,5,2004,PRK
58,Latvia,0,4,0,4,2004,LAT
59,Mexico,0,3,1,4,2004,MEX
60,Portugal,0,2,1,3,2004,POR
61,Finland,0,2,0,2,2004,FIN
61,Serbia and Montenegro,0,2,0,2,2004,SCG
63,Slovenia,0,1,3,4,2004,SLO
64,Estonia,0,1,2,3,2004,EST
65,Hong Kong,0,1,0,1,2004,HKG
65,India,0,1,0,1,2004,IND
65,Paraguay,0,1,0,1,2004,PAR
68,Colombia,0,0,2,2,2004,COL
68,Nigeria,0,0,2,2,2004,NIG
68,Venezuela,0,0,2,2,2004,VEN
71,Eritrea,0,0,1,1,2004,ERI
71,Mongolia,0,0,1,1,2004,MGL
71,Syria,0,0,1,1,2004,SYR
71,Trinidad and Tobago,0,0,1,1,2004,TTO
1,China,48,22,30,100,2008,CHN
2,United States,36,39,37,112,2008,USA
3,Russia,24,13,23,60,2008,ROC
4,Great Britain,19,13,19,51,2008,GBR
5,Germany,16,11,14,41,2008,GER
6,Australia,14,15,17,46,2008,AUS
7,South Korea,13,11,8,32,2008,KOR
8,Japan,9,8,8,25,2008,JPN
9,Italy,8,9,10,27,2008,ITA
10,France,7,16,20,43,2008,FRA
11,Netherlands,7,5,4,16,2008,NED
12,Ukraine,7,4,11,22,2008,UKR
13,Kenya,6,4,6,16,2008,KEN
14,Spain,5,11,3,19,2008,ESP
15,Jamaica,5,4,2,11,2008,JAM
16,Poland,4,5,2,11,2008,POL
17,Ethiopia,4,2,1,7,2008,ETH
18,Romania,4,1,4,9,2008,ROU
19,Cuba,3,10,17,30,2008,CUB
20,Canada,3,9,8,20,2008,CAN
21,Hungary,3,5,2,10,2008,HUN
22,Norway,3,5,1,9,2008,NOR
23,Brazil,3,4,10,17,2008,BRA
24,Belarus,3,4,7,14,2008,BLR
25,Czech Republic,3,3,1,7,2008,CZE
26,Slovakia,3,3,0,6,2008,SVK
27,New Zealand,3,2,4,9,2008,NZL
28,Georgia,3,2,2,7,2008,GEO
29,Kazakhstan,2,3,4,9,2008,KAZ
30,Denmark,2,2,3,7,2008,DEN
31,North Korea,2,2,2,6,2008,PRK
31,Thailand,2,2,2,6,2008,THA
33,Mongolia,2,2,0,4,2008,MGL
34,Switzerland,2,1,4,7,2008,SUI
35,Argentina,2,0,4,6,2008,ARG
36,Mexico,2,0,2,4,2008,MEX
37,Belgium,2,0,0,2,2008,BEL
38,Zimbabwe,1,3,0,4,2008,ZIM
39,Slovenia,1,2,2,5,2008,SLO
40,Azerbaijan,1,1,4,6,2008,AZE
40,Indonesia,1,1,4,6,2008,INA
42,Bulgaria,1,1,3,5,2008,BUL
42,Turkey,1,1,3,5,2008,TUR
44,Chinese Taipei,1,1,2,4,2008,TPE
44,Finland,1,1,2,4,2008,FIN
46,Latvia,1,1,1,3,2008,LAT
47,Dominican Republic,1,1,0,2,2008,DOM
47,Estonia,1,1,0,2,2008,EST
47,Portugal,1,1,0,2,2008,POR
47,Trinidad and Tobago,1,1,0,2,2008,TTO
51,India,1,0,2,3,2008,IND
52,Iran,1,0,1,2,2008,IRI
53,Cameroon,1,0,0,1,2008,CMR
53,Panama,1,0,0,1,2008,PAN
53,Tunisia,1,0,0,1,2008,TUN
56,Sweden,0,4,1,5,2008,SWE
57,Lithuania,0,3,2,5,2008,LTU
57,Nigeria,0,3,2,5,2008,NIG
59,Croatia,0,2,3,5,2008,CRO
60,Colombia,0,2,1,3,2008,COL
60,Greece,0,2,1,3,2008,GRE
62,Armenia,0,1,4,5,2008,ARM
63,Uzbekistan,0,1,3,4,2008,UZB
64,Austria,0,1,2,3,2008,AUT
64,Ireland,0,1,2,3,2008,GBR
64,Kyrgyzstan,0,1,2,3,2008,KGZ
64,Serbia,0,1,2,3,2008,SRB
68,Algeria,0,1,1,2,2008,ALG
68,Bahamas,0,1,1,2,2008,BAH
68,Morocco,0,1,1,2,2008,MAR
68,Tajikistan,0,1,1,2,2008,TJK
72,Chile,0,1,0,1,2008,CHI
72,Ecuador,0,1,0,1,2008,ECU
72,Iceland,0,1,0,1,2008,ISL
72,Malaysia,0,1,0,1,2008,MAS
72,Samoa,0,1,0,1,2008,SAM
72,Singapore,0,1,0,1,2008,SGP
72,South Africa,0,1,0,1,2008,RSA
72,Sudan,0,1,0,1,2008,SUD
72,Vietnam,0,1,0,1,2008,VIE
81,Egypt,0,0,2,2,2008,EGY
82,Afghanistan,0,0,1,1,2008,AFG
82,Israel,0,0,1,1,2008,ISR
82,Mauritius,0,0,1,1,2008,MRI
82,Moldova,0,0,1,1,2008,MDA
82,Togo,0,0,1,1,2008,TOG
82,Venezuela,0,0,1,1,2008,VEN
1,United States,48,26,30,104,2012,USA
2,China,39,31,22,92,2012,CHN
3,Great Britain,29,18,18,65,2012,GBR
4,Russia,18,21,26,65,2012,ROC
5,South Korea,13,9,9,31,2012,KOR
6,Germany,11,20,13,44,2012,GER
7,France,11,11,13,35,2012,FRA
8,Australia,8,15,12,35,2012,AUS
9,Italy,8,9,11,28,2012,ITA
10,Hungary,8,4,6,18,2012,HUN
11,Japan,7,14,17,38,2012,JPN
12,Iran,7,5,1,13,2012,IRI
13,Netherlands,6,6,8,20,2012,NED
14,New Zealand,6,2,5,13,2012,NZL
15,Ukraine,5,4,10,19,2012,UKR
16,Cuba,5,3,7,15,2012,CUB
17,Spain,4,10,6,20,2012,ESP
18,Jamaica,4,5,4,13,2012,JAM
19,Czech Republic,4,4,3,11,2012,CZE
20,South Africa,4,1,1,6,2012,RSA
21,North Korea,4,0,2,6,2012,PRK
22,Brazil,3,5,9,17,2012,BRA
23,Kazakhstan,3,2,6,11,2012,KAZ
23,Poland,3,2,6,11,2012,POL
25,Ethiopia,3,2,3,8,2012,ETH
26,Croatia,3,1,2,6,2012,CRO
27,Canada,2,6,10,18,2012,CAN
28,Belarus,2,5,3,10,2012,BLR
29,Kenya,2,4,7,13,2012,KEN
30,Denmark,2,4,3,9,2012,DEN
31,Romania,2,4,1,7,2012,ROU
32,Azerbaijan,2,2,5,9,2012,AZE
33,Switzerland,2,2,0,4,2012,SUI
34,Norway,2,1,1,4,2012,NOR
35,Lithuania,2,0,3,5,2012,LTU
36,Tunisia,2,0,1,3,2012,TUN
37,Sweden,1,4,3,8,2012,SWE
38,Colombia,1,3,5,9,2012,COL
39,Mexico,1,3,4,8,2012,MEX
40,Georgia,1,2,3,6,2012,GEO
41,Ireland,1,1,4,6,2012,GBR
42,Argentina,1,1,2,4,2012,ARG
42,Serbia,1,1,2,4,2012,SRB
42,Slovenia,1,1,2,4,2012,SLO
42,Trinidad and Tobago,1,1,2,4,2012,TTO
46,Turkey,1,1,1,3,2012,TUR
47,Dominican Republic,1,1,0,2,2012,DOM
48,Chinese Taipei,1,0,1,2,2012,TPE
48,Latvia,1,0,1,2,2012,LAT
50,Algeria,1,0,0,1,2012,ALG
50,Bahamas,1,0,0,1,2012,BAH
50,Bahrain,1,0,0,1,2012,BRN
50,Grenada,1,0,0,1,2012,GRN
50,Uganda,1,0,0,1,2012,UGA
50,Venezuela,1,0,0,1,2012,VEN
56,Egypt,0,3,1,4,2012,EGY
57,India,0,2,4,6,2012,IND
58,Mongolia,0,2,3,5,2012,MGL
59,Thailand,0,2,2,4,2012,THA
60,Bulgaria,0,2,1,3,2012,BUL
60,Finland,0,2,1,3,2012,FIN
60,Indonesia,0,2,1,3,2012,INA
63,Slovakia,0,1,3,4,2012,SVK
64,Belgium,0,1,2,3,2012,BEL
65,Armenia,0,1,1,2,2012,ARM
65,Estonia,0,1,1,2,2012,EST
65,Malaysia,0,1,1,2,2012,MAS
65,Puerto Rico,0,1,1,2,2012,PUR
65,Qatar,0,1,1,2,2012,QAT
70,Botswana,0,1,0,1,2012,BOT
70,Cyprus,0,1,0,1,2012,CYP
70,Gabon,0,1,0,1,2012,GAB
70,Guatemala,0,1,0,1,2012,GUA
70,Montenegro,0,1,0,1,2012,MNE
70,Portugal,0,1,0,1,2012,POR
76,Uzbekistan,0,0,3,3,2012,UZB
77,Greece,0,0,2,2,2012,GRE
77,Singapore,0,0,2,2,2012,SGP
79,Afghanistan,0,0,1,1,2012,AFG
79,Cameroon,0,0,1,1,2012,CMR
79,Hong Kong,0,0,1,1,2012,HKG
79,Kuwait,0,0,1,1,2012,KUW
79,Morocco,0,0,1,1,2012,MAR
79,Saudi Arabia,0,0,1,1,2012,KSA
79,Tajikistan,0,0,1,1,2012,TJK
79,Vietnam,0,0,1,1,2012,VIE
1,United States,46,37,38,121,2016,USA
2,Great Britain,27,23,17,67,2016,GBR
3,China,26,18,26,70,2016,CHN
4,Russia,19,17,20,56,2016,ROC
5,Germany,17,10,15,42,2016,GER
6,Japan,12,8,21,41,2016,JPN
7,France,10,18,14,42,2016,FRA
8,South Korea,9,3,9,21,2016,KOR
9,Italy,8,12,8,28,2016,ITA
10,Australia,8,11,10,29,2016,AUS
11,Netherlands,8,7,4,19,2016,NED
12,Hungary,8,3,4,15,2016,HUN
13,Brazil,7,6,6,19,2016,BRA
14,Spain,7,4,6,17,2016,ESP
15,Kenya,6,6,1,13,2016,KEN
16,Jamaica,6,3,2,11,2016,JAM
17,Croatia,5,3,2,10,2016,CRO
18,Cuba,5,2,4,11,2016,CUB
19,New Zealand,4,9,5,18,2016,NZL
20,Canada,4,3,15,22,2016,CAN
21,Uzbekistan,4,2,7,13,2016,UZB
22,Colombia,3,2,3,8,2016,COL
23,Switzerland,3,2,2,7,2016,SUI
24,Iran,3,1,4,8,2016,IRI
25,Greece,3,1,2,6,2016,GRE
26,Argentina,3,1,0,4,2016,ARG
27,Denmark,2,6,7,15,2016,DEN
28,Sweden,2,6,3,11,2016,SWE
29,South Africa,2,6,2,10,2016,RSA
30,Kazakhstan,2,5,10,17,2016,KAZ
31,Ukraine,2,5,4,11,2016,UKR
32,Serbia,2,4,2,8,2016,SRB
33,Poland,2,3,6,11,2016,POL
34,North Korea,2,3,2,7,2016,PRK
35,Belgium,2,2,2,6,2016,BEL
35,Thailand,2,2,2,6,2016,THA
37,Slovakia,2,2,0,4,2016,SVK
38,Georgia,2,1,4,7,2016,GEO
39,Azerbaijan,1,7,10,18,2016,AZE
40,Belarus,1,4,4,9,2016,BLR
41,Turkey,1,3,4,8,2016,TUR
42,Armenia,1,3,0,4,2016,ARM
43,Czech Republic,1,2,7,10,2016,CZE
44,Ethiopia,1,2,5,8,2016,ETH
45,Slovenia,1,2,1,4,2016,SLO
46,Indonesia,1,2,0,3,2016,INA
47,Romania,1,1,2,4,2016,ROU
48,Bahrain,1,1,0,2,2016,BRN
48,Vietnam,1,1,0,2,2016,VIE
50,Chinese Taipei,1,0,2,3,2016,TPE
51,Bahamas,1,0,1,2,2016,BAH
51,Independent Olympic Athletes,1,0,1,2,2016,IOA
51,Ivory Coast,1,0,1,2,2016,CIV
54,Fiji,1,0,0,1,2016,FIJ
54,Jordan,1,0,0,1,2016,JOR
54,Kosovo,1,0,0,1,2016,KOS
54,Puerto Rico,1,0,0,1,2016,PUR
54,Singapore,1,0,0,1,2016,SGP
54,Tajikistan,1,0,0,1,2016,TJK
60,Malaysia,0,4,1,5,2016,MAS
61,Mexico,0,3,2,5,2016,MEX
62,Venezuela,0,2,1,3,2016,VEN
63,Algeria,0,2,0,2,2016,ALG
63,Ireland,0,2,0,2,2016,GBR
65,Lithuania,0,1,3,4,2016,LTU
66,Bulgaria,0,1,2,3,2016,BUL
67,India,0,1,1,2,2016,IND
67,Mongolia,0,1,1,2,2016,MGL
69,Burundi,0,1,0,1,2016,BDI
69,Grenada,0,1,0,1,2016,GRN
69,Niger,0,1,0,1,2016,NIG
69,Philippines,0,1,0,1,2016,PHI
69,Qatar,0,1,0,1,2016,QAT
74,Norway,0,0,4,4,2016,NOR
75,Egypt,0,0,3,3,2016,EGY
75,Tunisia,0,0,3,3,2016,TUN
77,Israel,0,0,2,2,2016,ISR
78,Austria,0,0,1,1,2016,AUT
78,Dominican Republic,0,0,1,1,2016,DOM
78,Estonia,0,0,1,1,2016,EST
78,Finland,0,0,1,1,2016,FIN
78,Morocco,0,0,1,1,2016,MAR
78,Nigeria,0,0,1,1,2016,NIG
78,Portugal,0,0,1,1,2016,POR
78,Trinidad and Tobago,0,0,1,1,2016,TTO
78,United Arab Emirates,0,0,1,1,2016,UAE
1,United States,39,41,33,113,2020,USA
2,China,38,32,19,89,2020,CHN
3,Japan,27,14,17,58,2020,JPN
4,Great Britain,22,20,22,64,2020,GBR
5,ROC,20,28,23,71,2020,MAR
6,Australia,17,7,22,46,2020,AUS
7,Netherlands,10,12,14,36,2020,NED
8,France,10,12,11,33,2020,FRA
9,Germany,10,11,16,37,2020,GER
10,Italy,10,10,20,40,2020,ITA
11,Canada,7,7,10,24,2020,CAN
12,Brazil,7,6,8,21,2020,BRA
13,New Zealand,7,6,7,20,2020,NZL
14,Cuba,7,3,5,15,2020,CUB
15,Hungary,6,7,7,20,2020,HUN
16,South Korea,6,4,10,20,2020,KOR
17,Poland,4,5,5,14,2020,POL
18,Czech Republic,4,4,3,11,2020,CZE
19,Kenya,4,4,2,10,2020,KEN
20,Norway,4,2,2,8,2020,NOR
21,Jamaica,4,1,4,9,2020,JAM
22,Spain,3,8,6,17,2020,ESP
23,Sweden,3,6,0,9,2020,SWE
24,Switzerland,3,4,6,13,2020,SUI
25,Denmark,3,4,4,11,2020,DEN
26,Croatia,3,3,2,8,2020,CRO
27,Iran,3,2,2,7,2020,IRI
28,Serbia,3,1,5,9,2020,SRB
29,Belgium,3,1,3,7,2020,BEL
30,Bulgaria,3,1,2,6,2020,BUL
31,Slovenia,3,1,1,5,2020,SLO
32,Uzbekistan,3,0,2,5,2020,UZB
33,Georgia,2,5,1,8,2020,GEO
34,Chinese Taipei,2,4,6,12,2020,TPE
35,Turkey,2,2,9,13,2020,TUR
36,Greece,2,1,1,4,2020,GRE
36,Uganda,2,1,1,4,2020,UGA
38,Ecuador,2,1,0,3,2020,ECU
39,Ireland,2,0,2,4,2020,GBR
39,Israel,2,0,2,4,2020,ISR
41,Qatar,2,0,1,3,2020,QAT
42,Bahamas,2,0,0,2,2020,BAH
42,Kosovo,2,0,0,2,2020,KOS
44,Ukraine,1,6,12,19,2020,UKR
45,Belarus,1,3,3,7,2020,BLR
46,Romania,1,3,0,4,2020,ROU
46,Venezuela,1,3,0,4,2020,VEN
48,India,1,2,4,7,2020,IND
49,Hong Kong,1,2,3,6,2020,HKG
50,Philippines,1,2,1,4,2020,PHI
50,Slovakia,1,2,1,4,2020,SVK
52,South Africa,1,2,0,3,2020,RSA
53,Austria,1,1,5,7,2020,AUT
54,Egypt,1,1,4,6,2020,EGY
55,Indonesia,1,1,3,5,2020,INA
56,Ethiopia,1,1,2,4,2020,ETH
56,Portugal,1,1,2,4,2020,POR
58,Tunisia,1,1,0,2,2020,TUN
59,Estonia,1,0,1,2,2020,EST
59,Fiji,1,0,1,2,2020,FIJ
59,Latvia,1,0,1,2,2020,LAT
59,Thailand,1,0,1,2,2020,THA
63,Bermuda,1,0,0,1,2020,BER
63,Morocco,1,0,0,1,2020,MAR
63,Puerto Rico,1,0,0,1,2020,PUR
66,Colombia,0,4,1,5,2020,COL
67,Azerbaijan,0,3,4,7,2020,AZE
68,Dominican Republic,0,3,2,5,2020,DOM
69,Armenia,0,2,2,4,2020,ARM
70,Kyrgyzstan,0,2,1,3,2020,KGZ
71,Mongolia,0,1,3,4,2020,MGL
72,Argentina,0,1,2,3,2020,ARG
72,San Marino,0,1,2,3,2020,SMR
74,Jordan,0,1,1,2,2020,JOR
74,Malaysia,0,1,1,2,2020,MAS
74,Nigeria,0,1,1,2,2020,NIG
77,Bahrain,0,1,0,1,2020,BRN
77,Lithuania,0,1,0,1,2020,LTU
77,Namibia,0,1,0,1,2020,NAM
77,North Macedonia,0,1,0,1,2020,MKD
77,Saudi Arabia,0,1,0,1,2020,KSA
77,Turkmenistan,0,1,0,1,2020,TKM
83,Kazakhstan,0,0,8,8,2020,KAZ
84,Mexico,0,0,4,4,2020,MEX
85,Finland,0,0,2,2,2020,FIN
86,Botswana,0,0,1,1,2020,BOT
86,Burkina Faso,0,0,1,1,2020,BUR
86,Ghana,0,0,1,1,2020,GHA
86,Grenada,0,0,1,1,2020,GRN
86,Ivory Coast,0,0,1,1,2020,CIV
86,Kuwait,0,0,1,1,2020,KUW
86,Moldova,0,0,1,1,2020,MDA
86,Syria,0,0,1,1,2020,SYR
1,United States,40,44,42,126,2024,USA
2,China,40,27,24,91,2024,CHN
3,Japan,20,12,13,45,2024,JPN
4,Australia,18,19,16,53,2024,AUS
5,France,16,26,22,64,2024,FRA
6,Netherlands,15,7,12,34,2024,NED
7,Great Britain,14,22,29,65,2024,GBR
8,South Korea,13,9,10,32,2024,KOR
9,Italy,12,13,15,40,2024,ITA
10,Germany,12,13,8,33,2024,GER
11,New Zealand,10,7,3,20,2024,NZL
12,Canada,9,7,11,27,2024,CAN
13,Uzbekistan,8,2,3,13,2024,UZB
14,Hungary,6,7,6,19,2024,HUN
15,Spain,5,4,9,18,2024,ESP
16,Sweden,4,4,3,11,2024,SWE
17,Kenya,4,2,5,11,2024,KEN
18,Norway,4,1,3,8,2024,NOR
19,Ireland,4,0,3,7,2024,GBR
20,Brazil,3,7,10,20,2024,BRA
21,Iran,3,6,3,12,2024,IRI
22,Ukraine,3,5,4,12,2024,UKR
23,Romania,3,4,2,9,2024,ROU
24,Georgia,3,3,1,7,2024,GEO
25,Belgium,3,1,6,10,2024,BEL
26,Bulgaria,3,1,3,7,2024,BUL
27,Serbia,3,1,1,5,2024,SRB
28,Czech Republic,3,0,2,5,2024,CZE
29,Denmark,2,2,5,9,2024,DEN
30,Azerbaijan,2,2,3,7,2024,AZE
30,Croatia,2,2,3,7,2024,CRO
32,Cuba,2,1,6,9,2024,CUB
33,Bahrain,2,1,1,4,2024,BRN
34,Slovenia,2,1,0,3,2024,SLO
35,Chinese Taipei,2,0,5,7,2024,TPE
36,Austria,2,0,3,5,2024,AUT
37,Hong Kong,2,0,2,4,2024,HKG
37,Philippines,2,0,2,4,2024,PHI
39,Algeria,2,0,1,3,2024,ALG
39,Indonesia,2,0,1,3,2024,INA
41,Israel,1,5,1,7,2024,ISR
42,Poland,1,4,5,10,2024,POL
43,Kazakhstan,1,3,3,7,2024,KAZ
44,Jamaica,1,3,2,6,2024,JAM
44,South Africa,1,3,2,6,2024,RSA
44,Thailand,1,3,2,6,2024,THA
47,Ethiopia,1,3,0,4,2024,ETH
48,Switzerland,1,2,5,8,2024,SUI
49,Ecuador,1,2,2,5,2024,ECU
50,Portugal,1,2,1,4,2024,POR
51,Greece,1,1,6,8,2024,GRE
52,Argentina,1,1,1,3,2024,ARG
52,Egypt,1,1,1,3,2024,EGY
52,Tunisia,1,1,1,3,2024,TUN
55,Botswana,1,1,0,2,2024,BOT
55,Chile,1,1,0,2,2024,CHI
55,Saint Lucia,1,1,0,2,2024,LCA
55,Uganda,1,1,0,2,2024,UGA
59,Dominican Republic,1,0,2,3,2024,DOM
60,Guatemala,1,0,1,2,2024,GUA
60,Morocco,1,0,1,2,2024,MAR
62,Dominica,1,0,0,1,2024,DMA
62,Pakistan,1,0,0,1,2024,PAK
64,Turkey,0,3,5,8,2024,TUR
65,Mexico,0,3,2,5,2024,MEX
66,Armenia,0,3,1,4,2024,ARM
66,Colombia,0,3,1,4,2024,COL
68,Kyrgyzstan,0,2,4,6,2024,KGZ
68,North Korea,0,2,4,6,2024,PRK
70,Lithuania,0,2,2,4,2024,LTU
71,India,0,1,5,6,2024,IND
72,Moldova,0,1,3,4,2024,MDA
73,Kosovo,0,1,1,2,2024,KOS
74,Cyprus,0,1,0,1,2024,CYP
74,Fiji,0,1,0,1,2024,FIJ
74,Jordan,0,1,0,1,2024,JOR
74,Mongolia,0,1,0,1,2024,MGL
74,Panama,0,1,0,1,2024,PAN
79,Tajikistan,0,0,3,3,2024,TJK
80,Albania,0,0,2,2,2024,ALB
80,Grenada,0,0,2,2,2024,GRN
80,Malaysia,0,0,2,2,2024,MAS
80,Puerto Rico,0,0,2,2,2024,PUR
84,Cabo Verde,0,0,1,1,2024,CPV
84,Ivory Coast,0,0,1,1,2024,CIV
84,Peru,0,0,1,1,2024,PER
84,Qatar,0,0,1,1,2024,QAT
84,Refugee Olympic Team,0,0,1,1,2024,ROT
84,Singapore,0,0,1,1,2024,SGP
84,Slovakia,0,0,1,1,2024,SVK
84,Zambia,0,0,1,1,2024,ZAM
